BODY	body
BUTTON	button	
FORM	form
HEAD	head
INPUT	input
LINK	link
META	meta
ONCHANGE	onchange
OPTION	option
SCRIPT	script
SELECT	select
STYLE	style
TABLE	table
TD	td
TEXTAREA	textarea
TITLE	title
TR	tr
LANGUAGE	language
HREF	href
NAME	name
CLASS	class
TYPE	type
LABEL	label
HTML	html
IMG	img
